00211011
01101111
01010111
00111111
00101111
00301011