002110111
011011111
010101111
001111111
001011111
003010111